................................................................
................................................................
................................................................
.......#####....................................................
........###..............ooo....................................
.......................########.................................
.....##########.......###..............#.#......................
....................###................#.#......................
...................####.........................................
####################################.##############.....########
...................................#.#...............###........
........................############.#............###...........
........................#............#.........###..............
........................#.############.....####.................
........................#................##.....................
........................#################.......................

