................................................................
................................................................
................................................................
.......#####.....d..............................................
........###.....................................................
.......................########.................................
.....##########.......###..............#.#......................
....................###................#.#......................
...f...............####.......................................g.
####################################.##############.....########
...................................#.#...............###........
........................############.#............###...........
........................#............#.........###..............
........................#.############.....####.................
........................#................##.....................
........................#################.......................
