################################################################
#..............................................................#
#..............................................................#
#..............................................................#
#..............................................................#
#..............................................................#
#..............................................................#
#..............................................................#
#.............................f...............................g#
###################........############......###################
###################dddddddd############dddddd###################
................................................................
................................................................
................................................................
................................................................
................................................................
