#...............................................................
#...............................................................
#...............................................................
#......#####.....d..............................................
#.......###.....................................................
#......................########.................................
#....##########.......###..............#.#......................
#...................###................#.#......................
#.......f..........####.......................................g.
####################################.##############.....########
...................................#.#...............###........
........................############.#............###...........
........................#............#.........###..............
........................#.############.....####.................
........................#................##.....................
........................#################.......................
